18 12
100
111111111111114111
13001000xx71004001
10001020xx01002001
100210000081041401
120010001041201021
111014441001101011
124000416001920001
11400001x001000061
10000011xx00011111
10000212xx01000001
12100212xx21020051
111111111111111111