22 21
200
1111111111111111111111
1300000002120041012051
1111122111100000010041
1000000044100001010041
1020111020111111010001
1000001111166421010111
1000100000100001010121
1004100000104000010101
1022100244100001000001
1111110111111011110111
1004440008214040120601
1000000000014040100001
1600011111110000100021
1002001020010000000081
1000001000011111101111
1006001044020916104441
1000001044020000100441
1000001004010012100041
1000001000210110000001
1000022000010000000021
1111111111111111111111