28 25
300
1111111111111111111111111111
1302100201600010000000100051
1000100001602010000000000001
1110000001420000000000102021
1000000001020010000000120601
1000004441000010000011111411
1010042221000911111110002021
1210042221800000000000110001
1010004441111111111111000001
1610000008444000202000004241
1010000000040002020000002221
1210000101141100000444404241
1000010202141200004466440061
1001110011141111111144111111
1000100018000002122000044221
1000100010020000122000004421
1101101110000000100000000441
1000000911111101100011100041
1060006046046400000001000001
1040004024044400000001000001
1000000040000000100001000001
1000000000011100100001200001
1000200000044400100021000001
1220000000000000120001602201
1111111111111111111111111111