40 35
400
1111111111111111111111111111111111111111
1300000000212000000000000000000000000441
1000000040210000000011110000000002120041
1001111000010001110010661111111000200001
1001441010010001240010000000011100020041
1001441010016001144016000000001110000061
1001100010011100000010000014004110000001
1000000010002111111010000011400410000001
1000011110000102444019020061400411104111
1000012000004100444110000001400416004021
1200010004000100444000060001400411104111
1000010044000120000002000111000010000001
1110011000000111111100000160000120000001
1100001000006100000000002100041200000601
1200021001111100200200011100014000066001
1000011001222200000000010000010000000021
1044012001211111111100010222010444000001
1060010001222200006100010222010464002001
1000010001111110020110010222010444000001
1110000000000210000040010000012900000001
1200022220000410000240011111141111011011
1001111111110010000010000044164444010001
1004444400000010000010006464100440010001
1100000000000910200011004000100000010001
1611101116120610000001004440100000100001
1020000000211114000001400640102000104001
1000044000021044020001400000100002100001
1000042000001244000001112211101111600061
1000000000001000100000011110004441022201
1000100110111000000000000010000441022201
1000122100001111221114000010020041022201
1006111100004400110001000014000001600061
1000000020004400000000000014400001111111
1000000000000000000000000014440000000051
1111111111111111111111111111111111111111